#############
#P..........#
#...........#
#.123456789.#
#...........#
#.987654321.#
#...........#
#.123456789.#
#...........#
#..........E#
#############