####################
#..................#
#..............#...#
#. P .1..2..3..#E..#
#..............#...#
#..................#
####################
